.,.,.,.,.,.,.,.,.,.,.,.,.,.,.,.,.,.,.,.,.,.,.,.,.,.,.,.,.,.,.,#,#,#,#,.,.,.,.,.,.,.,.,.,.,.,.,.,.,.
.,.,.,.,.,.,.,.,.,.,.,.,.,.,.,.,.,.,.,.,.,.,.,.,.,.,.,.,.,.,.,.,.,.,.,.,.,.,.,.,.,.,.,.,.,.,.,.,.,.
.,.,.,.,.,.,.,.,.,.,.,.,.,.,.,.,.,.,.,.,.,.,.,.,.,.,.,.,.,.,.,.,.,.,.,.,.,.,.,.,.,.,.,.,.,.,.,.,.,.
.,.,.,.,.,.,.,.,.,.,.,.,.,.,.,.,.,.,.,.,.,.,.,.,.,.,.,.,.,.,.,.,.,.,.,.,.,.,.,.,.,.,.,.,.,.,.,.,.,.
.,.,.,.,#,#,#,#,#,.,.,.,.,.,.,.,.,.,.,.,.,.,.,.,.,.,.,.,.,.,.,.,.,.,.,.,.,.,.,.,.,.,.,.,.,.,.,.,.,.
.,.,.,.,.,.,.,.,.,.,.,.,.,.,.,.,.,.,.,.,.,.,.,.,.,.,.,.,.,.,.,.,.,.,.,.,.,.,.,.,.,.,.,.,.,.,.,.,.,.
.,.,.,.,.,.,.,.,.,.,.,.,.,.,.,.,.,.,.,.,.,.,.,.,.,.,.,.,.,.,.,.,S,.,.,.,.,.,.,.,.,.,.,.,.,.,.,.,.,.
.,.,.,.,.,.,.,.,.,#,.,.,.,.,.,.,.,.,.,.,.,.,.,.,.,.,.,.,.,.,.,.,.,.,.,.,.,.,.,#,#,#,#,.,.,.,.,.,.,.
.,.,.,.,.,.,.,.,.,#,.,.,.,.,.,.,.,.,.,.,.,.,.,.,.,.,.,.,.,.,.,.,.,.,G,G,G,.,.,.,.,.,.,.,.,.,.,.,.,.
.,.,.,.,.,.,.,.,.,#,.,.,.,.,.,.,.,.,.,.,.,.,.,.,.,.,.,.,.,.,.,.,.,G,G,.,G,.,.,.,.,.,.,.,.,Y,Y,.,Y,.
.,.,.,.,.,.,.,.,.,#,.,.,Y,.,Y,Y,Y,.,Y,Y,.,.,.,.,.,.,.,.,.,.,.,.,.,G,G,G,.,.,.,.,.,.,.,.,.,Y,Y,Y,Y,Y
.,.,.,.,.,.,.,.,.,#,.,.,.,Y,Y,Y,Y,Y,.,Y,.,.,.,.,.,.,.,.,.,.,.,.,.,G,.,G,G,.,.,.,.,.,.,.,.,Y,Y,Y,Y,Y
.,.,.,.,.,.,.,.,.,.,.,Y,Y,Y,Y,Y,Y,Y,Y,Y,.,.,.,.,.,.,.,.,G,G,G,G,G,G,G,G,.,.,.,.,.,.,.,.,.,Y,Y,Y,Y,.
.,.,.,.,.,.,.,.,.,.,.,Y,Y,Y,.,Y,Y,Y,Y,Y,.,.,.,.,.,.,.,G,G,.,.,G,.,.,G,G,.,.,.,.,.,.,.,.,.,Y,Y,Y,Y,Y
.,.,.,.,.,.,.,.,.,.,.,Y,.,.,Y,Y,Y,Y,Y,Y,.,.,.,.,.,.,.,G,G,G,G,G,.,G,G,.,.,.,.,.,.,.,.,.,.,Y,Y,.,#,Y
.,.,.,.,.,.,.,.,.,.,.,.,Y,.,Y,Y,Y,Y,Y,Y,.,.,.,.,.,.,.,G,.,G,.,G,G,G,G,G,.,.,.,.,.,.,.,.,.,.,Y,.,#,.
.,.,.,.,.,#,.,.,.,.,.,.,.,Y,.,.,Y,Y,Y,Y,.,.,.,.,.,.,.,G,G,G,G,G,.,.,.,G,.,.,.,.,.,.,.,.,.,Y,Y,Y,Y,.
.,.,.,.,.,#,#,#,#,#,.,Y,.,Y,.,Y,Y,.,Y,.,.,.,.,.,.,.,.,G,G,G,G,G,G,.,.,.,.,.,.,.,.,.,.,.,.,Y,Y,Y,.,Y
.,.,.,.,.,#,.,.,.,.,.,.,Y,Y,.,Y,.,.,Y,Y,.,.,.,.,.,.,.,G,G,G,G,.,G,.,G,G,.,.,.,.,.,.,.,.,.,.,.,.,B,B
.,.,.,.,.,#,.,.,.,.,.,.,.,.,.,.,.,.,.,.,.,.,.,.,.,.,.,.,.,G,G,.,G,.,G,G,.,.,.,.,.,.,.,.,#,#,.,.,B,B
.,.,.,.,.,.,.,.,.,.,.,.,.,.,.,.,.,.,.,.,.,.,.,.,.,.,.,.,G,G,.,.,.,G,G,G,.,.,.,.,.,.,.,.,.,.,.,.,B,.
.,.,.,.,.,.,.,.,.,.,.,.,.,.,.,.,.,.,.,.,.,.,.,.,.,.,.,.,.,.,.,.,.,.,.,.,.,.,.,.,.,.,.,.,.,.,.,.,B,B
.,.,.,.,.,.,.,.,.,.,.,.,.,.,.,.,.,.,.,.,.,.,.,.,.,.,.,.,.,.,.,.,.,.,.,.,.,.,.,.,.,.,.,#,#,#,#,.,.,.
.,.,.,.,.,.,.,.,.,.,.,.,.,.,.,.,.,.,.,.,.,#,.,.,.,.,.,.,.,.,.,.,.,.,.,.,.,.,.,.,.,.,.,.,.,.,.,.,.,.
.,.,.,.,.,.,.,.,.,.,.,.,.,.,.,.,.,.,B,B,B,#,.,.,.,.,.,.,.,.,.,.,.,.,.,.,.,.,.,.,.,.,.,.,.,.,.,.,.,.
.,.,.,.,.,.,.,.,.,.,.,.,.,.,.,.,.,B,.,.,.,#,B,B,.,.,.,.,.,.,.,.,.,.,.,.,.,.,.,.,.,.,.,.,.,.,.,.,.,.
.,.,.,.,.,.,.,.,.,.,.,.,.,.,.,.,.,B,.,B,B,#,B,#,.,.,.,.,.,.,.,.,.,.,.,.,.,.,.,.,.,.,.,.,.,.,.,.,.,.
.,.,.,.,.,.,.,.,.,.,.,.,.,.,.,.,.,B,B,B,B,#,B,#,.,.,.,.,.,.,.,.,.,.,.,.,.,.,.,.,.,.,.,.,.,.,.,.,.,.
.,.,.,.,.,.,.,.,.,.,.,.,.,.,.,.,.,B,B,B,B,B,B,B,.,.,.,.,.,.,.,.,.,.,.,.,.,.,.,.,#,#,#,.,.,.,.,.,.,.
.,.,.,.,.,.,.,.,.,.,.,.,.,.,.,.,.,B,.,B,.,.,B,.,.,.,.,.,.,.,.,.,.,.,.,.,.,.,.,.,.,.,#,#,#,#,#,.,.,.
.,.,.,.,.,.,.,.,.,.,.,.,.,#,.,.,.,B,B,B,B,B,.,B,.,.,.,.,.,.,.,.,.,.,.,.,.,.,.,.,.,.,.,.,.,.,.,.,.,.
.,.,.,.,.,.,.,.,.,.,.,.,.,#,.,.,.,.,.,.,.,.,.,.,.,.,.,.,B,.,B,B,.,.,.,.,.,.,.,.,.,.,.,.,.,.,.,.,.,.
.,.,.,.,.,.,.,.,.,.,.,.,.,.,.,.,.,.,.,.,.,.,.,.,.,.,.,.,B,B,.,B,B,.,.,.,.,.,.,.,.,.,.,.,.,.,.,.,.,.
.,.,.,.,.,.,.,.,.,.,.,.,.,.,.,.,.,.,.,.,.,.,.,.,.,.,.,.,B,B,B,.,B,.,.,.,.,.,.,.,.,.,.,.,.,.,.,.,.,.
.,.,.,.,.,.,.,.,.,.,.,.,.,.,.,.,.,.,.,.,.,.,.,.,.,.,.,.,B,B,B,B,.,.,.,.,.,.,.,.,.,.,.,.,.,.,.,.,.,.
.,.,.,.,.,.,.,.,.,.,.,.,.,.,.,.,.,.,.,.,.,.,.,.,.,.,.,.,B,B,B,B,B,.,.,.,.,.,.,.,.,.,.,.,.,.,.,.,.,.
.,.,.,.,.,.,.,.,.,.,.,.,.,.,.,.,.,.,.,.,.,.,.,.,.,.,.,.,.,.,.,.,.,.,.,.,.,.,.,.,.,.,.,.,.,.,.,.,.,.
.,.,.,.,.,.,.,.,.,.,.,.,.,.,.,.,.,.,.,.,.,.,.,.,.,.,.,.,.,.,.,.,.,.,.,.,.,.,.,.,.,.,.,.,.,.,.,.,.,.
.,.,.,.,.,.,.,.,.,.,.,.,.,.,.,.,.,.,.,.,.,.,.,.,.,.,.,.,.,.,.,.,.,.,.,.,.,.,.,.,.,.,.,.,.,.,.,.,.,.
.,.,.,.,.,.,.,.,.,.,.,.,.,G,.,G,.,G,G,G,G,G,G,G,.,.,.,.,.,.,.,.,.,.,.,.,.,.,.,.,.,.,.,.,.,.,.,.,.,.
.,.,.,.,.,.,.,.,.,.,.,.,.,.,G,G,G,G,.,G,G,.,G,G,.,.,.,.,.,.,.,.,.,.,.,.,.,.,.,.,.,.,.,.,.,.,.,.,.,.
.,.,.,.,.,.,.,.,.,.,.,.,.,.,G,G,G,G,G,G,G,.,G,G,.,.,.,.,.,.,.,.,.,.,.,.,.,.,.,.,.,.,.,.,.,.,.,.,.,.
.,.,.,.,.,.,.,.,.,.,.,.,.,.,G,G,G,G,G,G,G,Y,Y,G,.,.,.,.,.,.,.,.,.,#,.,.,.,.,.,.,.,.,.,.,.,.,.,.,.,.
.,.,.,.,.,.,.,.,.,.,.,.,.,G,G,G,G,G,G,G,G,Y,G,G,.,.,.,.,.,.,.,.,.,#,.,.,.,.,.,.,.,.,.,.,.,.,.,.,.,.
.,.,.,.,.,.,.,.,.,.,.,.,.,.,G,G,G,G,G,G,Y,Y,G,Y,.,.,.,.,.,.,.,.,.,#,.,.,.,.,.,.,.,.,.,.,.,.,.,.,.,.
.,.,.,.,.,.,.,.,.,.,.,.,.,G,G,G,G,G,G,G,.,G,G,Y,.,.,.,.,.,.,.,.,.,.,.,.,.,.,.,.,.,.,.,.,.,.,.,.,.,.
.,.,.,.,.,.,.,.,.,.,.,.,.,.,Y,G,#,#,#,#,G,G,Y,G,.,.,.,.,.,.,.,.,.,.,.,.,.,.,.,.,.,.,.,.,.,.,.,.,.,.
.,.,.,.,.,.,.,.,.,.,.,.,.,.,Y,G,G,.,.,G,G,G,G,G,.,.,.,.,.,.,.,.,.,.,.,.,Y,Y,.,Y,.,.,.,.,.,.,.,.,.,.
.,.,.,.,.,.,.,.,.,.,.,.,.,.,.,.,.,.,.,.,.,.,.,.,.,.,.,.,.,.,.,.,.,.,.,.,Y,Y,.,Y,.,.,.,.,.,.,.,.,.,.
.,.,.,.,.,.,.,.,.,.,.,.,.,.,.,.,.,.,.,.,.,.,.,.,.,.,.,.,.,.,.,.,.,.,.,.,.,Y,.,Y,.,.,.,.,.,.,.,.,.,.
